###############
.#............#
.#............#
.#..|.........1
##............#
.@............#
##............#
.#.......|....#
.#.....|......#
.#............#
.#............#
.#............#
###############