###############
.#............#
.#............#
.#............1
##............#
.@............#
##............#
.#.......|....#
.#............#
.#............#
.#............#
.#............#
###############