#...-..........
1...-..........
........||.....
-.#...........
..-....|.......
.-.........-..|
..-.......|....
########|......
...............
...-...#.......
....##########.
...-.....-....#
..............@