...............
.|........-....
.....-.......-.
..|............
.......-.......
.............@.
..##...-..#####
.|...-..-.|....
.|............|
....-.......|..
..-............
...........|...
.-....-.......1