...............
.|........-....
.....-.|.#...-.
..|.......-#...
......|.-|.#...
....|......#.@.
..#############
.|...-..-.|....
.|............|
....-.......|..
..-............
...........|...
.-....-.......1