###############
.@...........|#
##............#
##...-........#
##............#
..............#
##............#
#........|....#
#.............#
#..-..........#
#.####.#####..#
#......-......#
#############1#