...............
...............
.#..-....#.-...
.#..--.........
.#.......#-....
.#..-....#-..|.
.#...........|.
..#......#-..|.
..#..........|.
..#......#.-...
.#############.
....1#-.-.--...
|############.@